-21
21
-10
11
0000000000000000000000000000000000000000000
0000000000000000000000000000000000000000000
0001011011001000000010000000000000000000000
0001011011001000000010000000000000000000000
0001011111001000000010000000000000000000000
0001011101001000000010000011111110111111100
0001001001001000000010000011111110111111100
0001001001001000000010000011111110111111100
0001001001001000000010000011111110111111100
0001111111001111011110000011111110111111100
0001111111000000000000000011111111111111100
0000001000000111000000000011111110111111100
0000011100000111000000000000000000000000000
0000011100000111000000000000000000000000000
0000000000000111000000000000000000000000000
0000000000001111000000000000000000000000000
0000000000001111000000000000000000000000000
0000000000001111000000000000000000011111000
0000000000001111000000000000000000010001000
0000000000000000000000000000000000010001000
0000000000000000000000000000000000010001000
0000000000000000000000000000000000010001000
