-15
18
-9
2
0000000000000000000000000000000000
0000001111111000000001111111000000
1000001111111000000001111111000000
0000001111111000000001111111000010
0000001111111000000001111111000000
0000001111111000000001111111000000
0000001111111000000001111111000000
0000001111111000000001111111010000
0000000000000000000000000000000000
0000000000000000000000000000000000
0000000000000000001000000000000000
0000100000000000000000000000000000
