-21
21
-10
10
0000000000000000000000000000000000000000000
0000000000000000000000000000000000000000000
0000000000000000000000000000000000000000000
0000000000000000000000000000000000000000000
0000000000000000000000000000000000000000000
0000000000000000000000000000000000000000000
0000000000000000000000000000000000000000000
0000000000000000000000000000000000000000000
0000000000000000000000000000000000000000000
0000000000001111111000000001111111000000000
0000001000001111111000000001111111000000000
0000000000001111111000000001111111000010000
0000000000001111111000000001111111000000000
0000000000001111111000000001111111000000000
0000000000001111111000000001111111000000000
0000000000001111111000000001111111010000000
0000000000000000000000000000000000000000000
0000000000000000000000000000000000000000000
0000000000000000000000001000000000000000000
0000000000100000000000000000000000000000000
0000000000000000000000000000000000000000000
